(pronoun)mata	connector
age	i,
anata	pronoun
dakara	therefore
deshita	was
desu	is
eofm	eofm
gohan	i,
iki	i,
kanashii	i,
kanojo	pronoun
kare	pronoun
masen	verbneg
masendeshita	verbpastneg
mashita	verbpast
masu	verb
megohan	i,
mekanashii	i,
menaki	i,
merika	i,
meryouri	i,
mesensei	i,
metoire	i,
naki	i,
ni	destination
o	object
rika	i,
ryouri	i,
seito	i,
sensei	i,
shikashi	however
sore	it
soshite	then
toire	i,
wa	subject
watashi	i,
yari	i,
yorokobi	however
