age	
anata	you
dakara	therefore
deshita	therefore
desu	therefore
gohan	therefore
iki	therefore
kanashii	therefore
kanojo	she,her
kare	he,him
masen	he,him
masendeshita	he,him
mashita	he,him
masu	he,him
mata	also
naki	also
ni	also
o	also
rika	also
ryouri	also
seito	also
sensei	also
shikashi	however
sore	it
soshite	then
toire	then
wa	then
watashi	i,me
yari	i,me
yorokobi	i,me
